███████████████████████████████████████████████████████████████████████████████████████████████████████████████████████
█╔════════════════════════════════════════════════════════╣ ~  ~  ~  ~  ~  ~  ~  ~  ~  ~  ~  ~  ~  ~  ~  ~  ~  ~  ~  ~█
█║                                                        ║~  ~  ~ ╔════════════════════════════════════════╗ ~  ~  ~ █
█║  ╔═════════════╗                                       ║  ~  ~ ╔╝                                        ╚═╗ ~  ~  █
█║ ╔╝             ╚╗                                      ║ ~  ~  ║                                           ╚═╗ ~  ~█
█║ ║               ║                                      ║~  ~  ~║                                             ╚═╗ ~ █
█║ ║               ╚═══════════════╗                      ║  ~  ~ ║                                               ║~  █
█║ ║                               ╚╗                     ║ ~  ~  ╚╗                                              ║  ~█
█║ ║                                ╚╗                    ╚╗  ~  ~ ╚╗                                             ║ ~ █
█║ ║               ╔════════════╗    ╚╗                    ╚╗~  ~  ~╚╗                                           ╔╝~  █
█║ ║               ║            ╚╗    ╚╗                    ╚╗ ~  ~  ║                                           ║~  ~█
█║ ╚╗             ╔╝             ╚╗    ╚╗                    ╚╗  ~  ╔╝                                          ╔╝  ~ █
█║  ╚╗           ╔╝               ╚╗    ╚═════════════════════╩═════╝                                           ║  ~  █
█║   ╚╗         ╔╝                 ╚╗                                                                          ╔╝ ~  ~█
█║    ╚╗       ╔╝                   ╚╗                                                                         ║ ~  ~ █
█║     ╚╗     ╔╝                     ╚═══════════════════════════╦═════════╗                                  ╔╝~  ~  █
█║      ╚╗   ╔╝                                                  ╚═══╗  ~  ╚═══╗                              ║~  ~  ~█
█║       ║   ║                                                       ╚═══╗~  ~ ╚══════════════════════════════╝  ~  ~ █
█║       ║   ║                                                           ╚═══╗ ~  ~  ~  ~  ~  ~  ~  ~  ~  ~  ~  ~  ~  █
█║       ║   ║                                                               ╚═══╗  ~  ~  ~  ~  ~  ~  ~  ~  ~  ~  ~  ~█
█║       ║   ╚╗                                                                  ╚═══╗~  ~  ~  ~  ~  ~  ~  ~  ~  ~  ~ █
█║       ║    ╚═══════════════════════════════════════════════════╗                  ╚═══════════════════════════════╦█
█║       ╚╗                                                       ╚╗                                                 ║█
█║        ╚╗                                                       ╚╗                                                ║█
█║         ╚═══════════════════════════════════════════════════╗    ╚╗                                               ║█
█║                                                             ╚╗    ║                                               ║█
█║                                                              ╚╗   ╚══════════╗                                    ║█
█║                                                               ║              ╚╗                                   ║█
█║                                                               ║               ╚╗                                  ║█
█║    ╔═══════╗                                                  ║   ╔════════════╝                                  ║█
█║  ╔═╝       ╚═╗                                                ║   ║                                               ║█
█║╔═╝           ╚═╗                                              ║   ║                                               ║█
█║║               ║                                              ║   ║                                               ║█
█║╚═╗           ╔═╝                 ╔════════════════════════════╝   ╚══════════════════╗                            ║█
█║  ╚═╗       ╔═╝                  ╔╝                                                   ╚╗                           ║█
█║    ╚═╗   ╔═╝                   ╔╝                                                     ╚╗                          ║█
█║      ║   ║                     ║    ╔═════════════════════════╗   ╔═══════════════╗    ║                          ║█
█║      ║   ║                     ║   ╔╝                         ║   ║               ╚╗   ║                          ║█
█║      ║   ║                     ║   ║                          ║   ║                ║   ║                          ║█
█║      ║   ║                     ║   ║                          ║   ║                ║   ║                          ║█
█║      ║   ║                     ║   ║                          ║   ║                ║   ║                          ║█
█║      ║   ║                     ╚╗ ╔╝                          ║   ║                ║   ║                          ║█
█║      ║   ║                      ╚═╝                           ║   ║                ║   ║                          ║█
█║      ║   ╚╗                                                  ╔╝   ║                ║   ║                          ║█
█║      ║    ╚══════════════════════════════════════════════════╝    ║                ║   ║                          ║█
█║      ╚╗                                                          ╔╝                ║   ║                          ║█
█║       ╚╗                                                        ╔╝                 ║   ║                          ║█
█║        ╚════════════════════════════════════════════════════════╝                  ║   ║                          ║█
█║                                                                                   ╔╝   ╚╗                         ║█
█╚═══════════════════════════════════════════════════════════════════════════════════╣     ╠═════════════════════════╝█
███████████████████████████████████████████████████████████████████████████████████████████████████████████████████████