█████████████████████████████████████████████████████████████████████████████████████████████
█                                         ║~  ~ ║                                           █
█                                         ║  ~  ║                                           █
█     ╔═════════════════════════════╗     ║ ~  ~║                                           █
█     ║  ┌┐ ┌┐┌┐ ┌┐┌┐ ┌┐┌┐ ┌┐┌┐ ┌┐  ║     ║~  ~ ║                                           █
█     ║  │├─┤└┤└┬┘├┘├─┤└┤└┬┘├┘├─┤│  ║     ║  ~  ║                                           █
█     ║  ├┴┬┴┬┴┬┴┬┴┬┴┬┴┬┴┬┴┬┴┬┴┬┴┤  ║     ║ ~  ~║                                           █
█     ║  ├┬┴┬┴┬┴┬┴┬┴┬┴┬┴┬┴┬┴┬┴┬┴┬┤  ║     ║~  ~ ║                                           █
█     ║  ├┴┬┼─┼┬┴┬┴┬┤ ├┬┴┬┴┬┼─┼┬┴┤  ║     ║  ~  ║                                           █
█     ║  ├┬┴┤ ├┴┬┴┬┴┼─┼┴┬┴┬┴┤ ├┴┬┤  ║     ║ ~  ~║                                           █
█     ║  ├┴┬┴┬┴┬┴┬┼─┴─┴─┼┬┴┬┴┬┴┬┴┤  ║     ║~  ~ ║                                           █
█     ║  ├┬┴┬┴┬┴┬┼┘┌┬┬┬┐└┼┬┴┬┴┬┴┬┤  ║     ║  ~  ║                                           █
█     ║  ├┴┬┴┬┴┬┴┤┌┤├┼┤├┐├┴┬┴┬┴┬┴┤  ║     ║ ~  ~║                                           █
█     ║  ├┬┴┬┴┬┴┬┤│├┤│├┤│├┬┴┬┴┬┴┬┤  ║     ║~  ~ ║                                           █
█     ║  ├┴┬┴┬┴┬┴┤├┤├┼┤├┤├┴┬┴┬┴┬┴┤  ║     ║  ~  ║                                           █
█     ║  └─┴─┴─┴─┴╔═════╗┴─┴─┴─┴─┘  ║     ║ ~  ~║                                           █
█     ╚═══════════╝     ╚═══════════╝     ║~  ~ ║                                           █
█                                         ║  ~  ║                                           █
█                                         ║ ~  ~║                                           █
█                                         ║~  ~ ║                                           █
█                                         ║  ~  ║                                           █
█                                         ║ ~  ~║                                           █
█                                         ║~  ~ ║                                           █
█                                         ║  ~  ║                                           █
█                                         ║ ~  ~║                                           █
█                                         ║~  ~ ║                                           █
█                                         ║  ~  ╚╗                                          █
█                                         ║ ~  ~ ╚╗                                         █
█                                         ╚╗  ~  ~╚╗                                        █
█                                          ╚╗~  ~  ╚═══════════════════════════☼─┬─┬─☼══════█
█                                           ╚╗ ~  ~  ~  ~  ~  ~  ~  ~  ~  ~  ~ ║░│░│░║~  ~  █
█                                            ╚╗  ~  ~  ~  ~  ~  ~  ~  ~  ~  ~  ║─┼─┼─║  ~  ~█
█                                             ╚╗~  ~  ~  ~  ~  ~  ~  ~  ~  ~  ~║░│░│░║ ~  ~ █
█                                              ╚═══════════════════════════════☼─┴─┴─☼══════█
█                                                                                           █
█                                                                                           █
█                                                                                           █
█                                                                                           █
█                                                                                           █
█                                                                                           █
█████████████████████████████████████████████████████████████████████████████████████████████