█████████████████████████████████████████████████████████████████████████████████████████████████████████████████████████████████████████████████████████████████████████████████████████████████████████████████████████████████████████████████████████████████████████████████████████████████████████████████████████████████████████████████████████████████████████████████████████████████████████████████████████████████████████████████████████████████████████████████████████████████████████████████████
█                                         ║~  ~ ║                                                                                                                       ╚═╗                 ╚═╗                                            ╚╗ ~  ~  ~  ~  ~  ~  ~  ~  ~ ╔╝                                            ╔═╝                 ╔═╝                                       ║~  ~ ║                                                                                                                         █
█                                         ║  ~  ║                                                                                                                         ╚═╗                 ╚═╗                                           ╚╗  ~  ~  ~  ~  ~  ~  ~  ~ ╔╝                                           ╔═╝                 ╔═╝                                         ║  ~  ║                                                                                                                         █
█     ╔═════════════════════════════╗     ║ ~  ~║                                                                       ╔═════════════════════════════╗                     ╚═╗                 ╚═╗                                          ╚══════╗~  ~  ~  ~ ╔══════╝                                          ╔═╝                 ╔═╝                                           ║ ~  ~║     ╔═════════════════════════════╗                                                                                     █
█     ║  ┌┐ ┌┐┌┐ ┌┐┌┐ ┌┐┌┐ ┌┐┌┐ ┌┐  ║     ║~  ~ ║                                                                       ║                             ║                       ╚═╗                 ╚═╗                                               ╚╗ ~  ~  ~ ╔╝                                               ╔═╝                 ╔═╝                                             ║~  ~ ║     ║    ^                   ^    ║                                                                                     █
█     ║  │├─┤└┤└┬┘├┘├─┤└┤└┬┘├┘├─┤│  ║     ║  ~  ║                                                                       ║          /│                 ║                         ╚═╗                 ╚═╗                                              ╚╗  ~  ~ ╔╝                                              ╔═╝                 ╔═╝                                               ║  ~  ║     ║   /¯\                 /¯\   ║                                                                                     █
█     ║  ├┴┬┴┬┴┬┴┬┴┬┴┬┴┬┴┬┴┬┴┬┴┬┴┤  ║     ║ ~  ~║                                                                       ║         //│       ^         ║                           ╚═╗                 ╚═╗                                             ╚╗~  ~ ╔╝                                             ╔═╝                 ╔═╝                                                 ║ ~  ~║     ║  /¯¯¯\   /¯¯¯¯¯¯¯\   /¯¯¯\  ║                                                                                     █
█     ║  ├┬┴┬┴┬┴┬┴┬┴┬┴┬┴┬┴┬┴┬┴┬┴┬┤  ║     ║~  ~ ║                                                                       ║        /│/│  /│  /│\        ║                             ╚═╗                 ╚═╗                                            ║  ~  ║                                            ╔═╝                 ╔═╝                                                   ║~  ~ ║     ║ /¯¯¯¯¯\ /¯¯/¯¯¯\¯¯\ /¯¯¯¯¯\ ║                                                                                     █
█     ║  ├┴┬┼─┼┬┴┬┴┬┤ ├┬┴┬┴┬┼─┼┬┴┤  ║     ║  ~  ║                                                                       ║       ////│ //│ //\\\       ║                               ╚═╗                 ╚═╗                                          ║ ~  ~║                                          ╔═╝                 ╔═╝                                                     ║  ~  ║     ║ │¯¯¯¯¯│ │¯¯_/¯\_¯¯│ │¯¯¯¯¯│ ║                                                                                     █
█     ║  ├┬┴┤ ├┴┬┴┬┴┼─┼┴┬┴┬┴┤ ├┴┬┤  ║     ║ ~  ~║                                                                       ║      /│/│/│/│/│/│/│\│\      ║                                 ╚═╗                 ╚══════╗                 ╔═════════════════╣~~~~~╠═════════════════╗                 ╔══════╝                 ╔═╝                                                       ║ ~  ~║     ║ │ ┌┬┐ └─┘  │(░)│  └─┘ ┌┬┐ │ ║                                                                                     █
█     ║  ├┴┬┴┬┴┬┴┬┼─┴─┴─┼┬┴┬┴┬┴┬┴┤  ║     ║~  ~ ║                                                                       ║     //////////////\\\\\     ║                                   ╚═╗                      ╚═╗             ╔═╝                 ║~~~~~║                 ╚═╗             ╔═╝                      ╔═╝                                                         ║~  ~ ║     ║ │ ├┼┤     ┌─────┐     ├┼┤ │ ║                                                                                     █
█     ║  ├┬┴┬┴┬┴┬┼┘┌┬┬┬┐└┼┬┴┬┴┬┴┬┤  ║     ║  ~  ║                                                                       ║    /│/│/│/│┌┬┬┬┐│/│\│\│\    ║                                     ╚═╗                      ╚═╗         ╔═╝                   ║~~~~~║                   ╚═╗         ╔═╝                      ╔═╝                                                           ║  ~  ║     ║ │ └┴┘    ┌┘┌┬┬┬┐└┐    └┴┘ │ ║                                                                                     █
█     ║  ├┴┬┴┬┴┬┴┤┌┤├┼┤├┐├┴┬┴┬┴┬┴┤  ║     ║ ~  ~║                                                                       ║   ////////┌┤├┼┤├┐/\\\\\\\   ║                                       ╚═╗                      ╚═════════╝                     ║~~~~~║                     ╚═════════╝                      ╔═╝                                                             ║ ~  ~║     ║ │        │┌┤├┼┤├┐│        │ ║                                                                                     █
█     ║  ├┬┴┬┴┬┴┬┤│├┤│├┤│├┬┴┬┴┬┴┬┤  ║     ║~  ~ ║                                                                       ║  /│/│/│/│/│├┤│├┤│/│\│\│\│\  ║                                         ╚═╗                                                    ║~~~~~║                                                    ╔═╝                                                               ║~  ~ ║     ║ │        ││├┤│├┤││        │ ║                                                                                     █
█     ║  ├┴┬┴┬┴┬┴┤├┤├┼┤├┤├┴┬┴┬┴┬┴┤  ║     ║  ~  ║                                                                       ║ //////////├┤├┼┤├┤/\\\\\\\\\ ║                                           ╚═╗                                                  ║~~~~~║                                                  ╔═╝                                                                 ║  ~  ║     ║ │        │├┤├┼┤├┤│        │ ║                                                                                     █
█     ║  └─┴─┴─┴─┴╔═════╗┴─┴─┴─┴─┘  ║     ║ ~  ~║                                                                       ║ ¯¯¯¯¯¯¯¯¯¯╔═════╗¯¯¯¯¯¯¯¯¯¯ ║                                             ╚═╗                   ┌┬┬┬┐                        ║~~~~~║                        ┌┬┬┬┐                   ╔═╝                                                                   ║ ~  ~║     ║ └────────┘╔═════╗└────────┘ ║                        ╔═╗                   ╔═╗                                    █
█     ╚═══════════╝     ╚═══════════╝     ║~  ~ ║                                                                       ╚═══════════╝     ╚═══════════╝                                               ╚═╗                ┌┤├┼┤├┐                       ║~~~~~║                       ┌┤├┼┤├┐                ╔═╝                                                                     ║~  ~ ║     ╚═══════════╝     ╚═══════════╝                        ║ ╚═╗               ╔═╝ ║                                    █
█                                         ║  ~  ║                                                                                                                                                       ╚═╗              │├┤│├┤│                       ║~~~~~║                       │├┤│├┤│              ╔═╝                                                                       ║  ~  ║                                                            ║   ╚═╗           ╔═╝   ║                                    █
█                                         ║ ~  ~║                                                                                                                                                         ╚═╗            ├┤├┼┤├┤                       ║~~~~~║                       ├┤├┼┤├┤            ╔═╝                                                                         ║ ~  ~║                                                            ║     ║           ║     ║                                    █
█                                         ║~  ~ ║                                                                                                                                                           ╚══════╗     ╔═════╗     ╔═════════════════╣§§§§§╠═════════════════╗     ╔═════╗     ╔══════╝                                                                           ║~  ~ ║                                                            ╚═╗   ║           ║   ╔═╝                                    █
█                                         ║  ~  ║                                                                                                                                                                  ╚═╗   ║     ║   ╔═╝                 ║ ~  ~║                 ╚═╗   ║     ║   ╔═╝                                                                                  ║  ~  ║                                                              ╚═╗ ║           ║ ╔═╝                                      █
█                                         ║ ~  ~║                                                                                                                                                                    ╚═╗ ║     ║ ╔═╝                   ║~  ~ ║                   ╚═╗ ║     ║ ╔═╝                                                                                    ║ ~  ~║                                                                ╚═╣           ╠═╝                                        █
█                                         ║~  ~ ║                                                                                                                                                                      ╚═╝     ╚═╝                     ║  ~  ║                     ╚═╝     ╚═╝                                                                                      ║~  ~ ║                                                                  ║           ║                                          █
█                                         ║  ~  ║                                                                                                                                                                                                      ║ ~  ~║                                                                                                                      ║  ~  ║                                                                  ║           ║                                          █
█                                         ║ ~  ~║                                                                                                                                                                                                      ║~  ~ ║                                                                                                                      ║ ~  ~║                                                                  ║           ║                                          █
█                                         ║~  ~ ║                                                                                                                                                                                                      ║  ~  ║                                                                                                                      ║~  ~ ║                                                                  ║           ║                                          █
█                                         ║  ~  ╚╗                                                                                                                                                                                                     ║ ~  ~║                                                                                                                      ║  ~  ║                                                                  ║           ║                                          █
█                                         ║ ~  ~ ╚╗                                                                                                                                                                                                    ║~  ~ ║                                                                                                                      ║ ~  ~║                                                                  ║           ║                                          █
█                                         ╚╗  ~  ~╚╗                                                                                                                                                                                                   ║  ~  ║                                                                                                                      ║~  ~ ║                                                                  ║           ║                                          █
█                                          ╚╗~  ~  ╚═══════════════════════════☼─┬─┬─☼══════════════════════╗                                                                                                                                          ║ ~  ~║                                                                                                                      ║  ~  ║                                                                  ║           ║                                          █
█                                           ╚╗ ~  ~  ~  ~  ~  ~  ~  ~  ~  ~  ~ ║░│░│░║~  ~  ~  ~  ~  ~  ~  ~╚╗                                                                                                                                         ║~  ~ ║                                                                                                                      ║ ~  ~║                                                                  ║           ║                                          █
█                                            ╚╗  ~  ~  ~  ~  ~  ~  ~  ~  ~  ~  ║─┼─┼─║  ~  ~  ~  ~  ~  ~  ~  ╚╗                                                                                                                                        ║  ~  ║                                                                                                                      ║~  ~ ║                                                                  ║           ║                                          █
█                                             ╚╗~  ~  ~  ~  ~  ~  ~  ~  ~  ~  ~║░│░│░║ ~  ~  ~  ~  ~  ~  ~  ~ ╚╗                                                                                                                                       ║ ~  ~║                                                                                                                      ║  ~  ║                                                                  ║           ║                                          █
█                                              ╚═══════════════════════════════☼─┴─┴─☼══════════════════╗  ~  ~╚╗                                                                                                                                      ║~  ~ ║                                                                                                                      ║ ~  ~║                                                                  ║           ║                                          █
█                                                                                                       ╚╗~  ~  ╚╗                                                                                                                                     ║  ~  ║                                                                                                                      ║~  ~ ║                                                                  ║           ║                                          █
█                                                                                                        ╚╗ ~  ~ ║                                                                                                                                     ║ ~  ~║                                                                                                                      ║  ~  ║                                                                  ║           ║                                          █
█                                                                                                         ╚╗  ~  ║                                                                                                                                     ║~  ~ ║                                                                                                                      ║ ~  ~║                                                                  ║           ║                                          █
█                                                                                                          ║ ~  ~║                                                                                                                                     ║  ~  ║                                                                                                                      ║~  ~ ║                                                                  ║           ║                                          █
█████████████████████████████████████████████████████████████████████████████████████████████████████████████████████████████████████████████████████████████████████████████████████████████████████████████████████████████████████████████████████████████████████████████████████████████████████████████████████████████████████████████████████████████████████████████████████████████████████████████████████████████████████████████████████████████████████████████████████████████████████████████████████