█████████████████████████████████████████████████████████████████████████████████████████████
█                                         ║~  ~ ║                                           █
█                                         ║  ~  ║                                           █
█     ╔═════════════════════════════╗     ║ ~  ~║                                           █
█     ║  ┌┐ ┌┐┌┐ ┌┐┌┐ ┌┐┌┐ ┌┐┌┐ ┌┐  ║     ║~  ~ ║                                           █
█     ║  │├─┤└┤└┬┘├┘├─┤└┤└┬┘├┘├─┤│  ║     ║  ~  ║                                           █
█     ║  ├┴┬┴┬┴┬┴┬┴┬┴┬┴┬┴┬┴┬┴┬┴┬┴┤  ║     ║ ~  ~║                                           █
█     ║  ├┬┴┬┴┬┴┬┴┬┴┬┴┬┴┬┴┬┴┬┴┬┴┬┤  ║     ║~  ~ ║                                           █
█     ║  ├┴┬┼─┼┬┴┬┴┬┤ ├┬┴┬┴┬┼─┼┬┴┤  ║     ║  ~  ║                                           █
█     ║  ├┬┴┤ ├┴┬┴┬┴┼─┼┴┬┴┬┴┤ ├┴┬┤  ║     ║ ~  ~║                                           █
█     ║  ├┴┬┴┬┴┬┴┬┼─┴─┴─┼┬┴┬┴┬┴┬┴┤  ║     ║~  ~ ║                                           █
█     ║  ├┬┴┬┴┬┴┬┼┘┌┬┬┬┐└┼┬┴┬┴┬┴┬┤  ║     ║  ~  ║                                           █
█     ║  ├┴┬┴┬┴┬┴┤┌┤├┼┤├┐├┴┬┴┬┴┬┴┤  ║     ║ ~  ~║                                           █
█     ║  ├┬┴┬┴┬┴┬┤│├┤│├┤│├┬┴┬┴┬┴┬┤  ║     ║~  ~ ║                                           █
█     ║  ├┴┬┴┬┴┬┴┤├┤├┼┤├┤├┴┬┴┬┴┬┴┤  ║     ║  ~  ║                                           █
█     ║  └─┴─┴─┴─┴╔═════╗┴─┴─┴─┴─┘  ║     ║ ~  ~║                                           █
█     ╚═══════════╝     ╚═══════════╝     ║~  ~ ║                                           █
█                                         ║  ~  ║                                           █
█                                         ║ ~  ~║                                           █
█                                         ║~  ~ ║                                           █
█                                         ║  ~  ║                                           █
█                                         ║ ~  ~║                                           █
█                                         ║~  ~ ║                                           █
█                                         ║  ~  ║                                           █
█                                         ║ ~  ~║                                           █
█                                         ║~  ~ ║                                           █
█                                         ║  ~  ╚╗                                          █
█                                         ║ ~  ~ ╚╗                                         █
█                                         ╚╗  ~  ~╚╗                                        █
█                                          ╚╗~  ~  ╚═══════════════════════════☼─┬─┬─☼══════█
█                                           ╚╗ ~  ~  ~  ~  ~  ~  ~  ~  ~  ~  ~ ║░│░│░║~  ~  █
█                                            ╚╗  ~  ~  ~  ~  ~  ~  ~  ~  ~  ~  ║─┼─┼─║  ~  ~█
█                                             ╚╗~  ~  ~  ~  ~  ~  ~  ~  ~  ~  ~║░│░│░║ ~  ~ █
█                                              ╚═══════════════════════════════☼─┴─┴─☼══════█
█                                                                                           █
█                                                                                           █
█                                                                                           █
█                                                                                           █
█                                                                                           █
█                                                                                           █
█                                                                                           █
█                                                                                           █
█                                                                                           █
█                                                                                           █
█                                                                                           █
█                                                                                           █
█                                                                                           █
█                                                                                           █
█                                                                                           █
█                                                                                           █
█                                                                                           █
█                                                                                           █
█                                                                                           █
█                                                                                           █
█                                                                                           █
█                                                                                           █
█                                                                                           █
█                                                                                           █
█     ╔═════════════════╗                                                                   █
█     ║                 ║                                                                   █
█     ║    _________    ║                     ╔═╗                                           █
█     ║   /┌───────┐\   ║                   ╔═╝ ║                                           █
█     ║  /┌┘ ┌───┐ └┐\  ║                 ╔═╝   ║                                           █
█     ║ /┌┘ ┌┘┌┬┐└┐ └┐\ ║               ╔═╝     ║                                           █
█     ║/┌┘  │┌┤│├┐│  └┐\║             ╔═╝     ╔═╝                                           █
█     ║││   ││├┼┤││   ││║           ╔═╝     ╔═╝                                             █
█     ║││  ┌┘├┤│├┤└┐  ││║         ╔═╝     ╔═╝                                             ╔═█
█     ║└┴──┘╔═════╗└──┴┘║       ╔═╝     ╔═╝                                             ╔═╝ █
█     ╚═════╝     ╚═════╝     ╔═╝     ╔═╝                                             ╔═╝   █
█                           ╔═╝     ╔═╝                 ╔═════════════════════════════╝     █
█                         ╔═╝     ╔═╝                 ╔═╝                                 ╔═█
█                       ╔═╝     ╔═╝                 ╔═╝                                 ╔═╝ █
█                       ║     ╔═╝                 ╔═╝                                 ╔═╝   █
█                       ║   ╔═╝                 ╔═╝     ╔═════════════════════════════╝     █
█                       ║ ╔═╝                 ╔═╝     ╔═╝                                   █
█                       ╠═╝                 ╔═╝     ╔═╝                                     █
█                       ║                 ╔═╝     ╔═╝                                       █
█                       ║                 ║     ╔═╝                                         █
█                       ║                 ║   ╔═╝                                           █
█                       ║                 ║ ╔═╝                                             █
█                       ╚═╗               ╚═╝                                               █
█                         ╚═╗                                                               █
█                           ╚═╗                                                             █
█                             ║                                                             █
█                             ║                                                             █
█                             ║                                                             █
█                             ║                                                             █
█                             ║                                                             █
█                             ║                                    ╔════════════════════════█
█                             ║                                    ║                        █
█                             ║                                    ║                        █
█                             ║                                    ║         /¯¯¯¯¯¯¯¯¯\    █
█                             ║                                    ║        /¯¯¯¯¯¯¯¯¯¯¯\   █
█                             ║                                    ║       /¯¯¯¯¯¯¯¯¯¯¯¯¯\  █
█                             ║                                    ║ /¯¯¯¯¯¯¯\¯¯¯¯¯¯¯¯¯¯/¯¯¯█
█                             ║                                    ║/¯¯¯¯¯¯¯¯¯\┌┐       │¯¯¯█
█                             ║                                    ║│¯¯¯¯¯¯¯¯¯│└┘  ┌┬┬┐ │ ┌┐█
█                             ║                                    ║│ ┌┐      │    ├┤├┤ │ └┘█
█                           ╔═╣                                    ║│ └┘  ┌┬┬┐├────┴┴┴┴─┤   █
█                         ╔═╝ ║                                    ║│     ├┤├┤│         └───█
█                       ╔═╝   ║                                    ║└─────┴┴┴┴┘╔═════╗      █
█                     ╔═╝     ║                                    ╚═══════════╝     ╚══════█
█                   ╔═╝     ╔═╝                                                             █
█                 ╔═╝     ╔═╝                                                               █
█═════════════════╝     ╔═╝                                                                 █
█                     ╔═╝                                                                   █
█                   ╔═╝                                                                     █
█═══════════════════╩══════════════════════════════════╗                                    █
█ ~  ~  ~  ~  ~  ~  ~  ~  ~  ~  ~  ~  ~  ~  ~  ~  ~  ~ ╚╗                                   █
█~  ~  ~  ~  ~  ~  ~  ~  ~  ~  ~  ~  ~  ~  ~  ~  ~  ~  ~╚╗                                  █
█  ~  ~  ~  ~  ~  ~  ~  ~  ~  ~  ~  ~  ~  ~  ~  ~  ~  ~  ╚╗                                 █
█══════════════════════════════════════════════════╗ ~  ~ ╚╗                                █
█                                                  ╚╗  ~  ~╚╗               ╔══             █
█     ╔═════════════════════════════╗               ╚╗~  ~  ║             ╔═╝               █
█     ║                             ║                ╚╗ ~  ~║           ╔═╝                 █
█     ║              ^              ║                 ║~  ~ ║         ╔═╝                   █
█     ║             /┬\             ║                 ║  ~  ║       ╔═╝                     █
█     ║            /┬┴┬\            ║                 ║ ~  ~║     ╔═╝                       █
█     ║           /┬┴┬┴┬\           ║                 ║~  ~ ║   ╔═╝                         █
█     ║          /┬┴┬┴┬┴┬\          ║                 ║  ~  ║ ╔═╝                           █
█     ║         /┬┼─┴─┴─┼┬\         ║                 ║ ~  ~╠═╝                             █
█     ║        /┬┼┘┌┬┬┬┐└┼┬\        ║                 ║~  ~ ║                               █
█     ║       /┬┴┤┌┤├┼┤├┐├┴┬\       ║                 ║  ~  ║                               █
█     ║      /┬┴┬┤│├┤│├┤│├┬┴┬\      ║                 ║ ~  ~║                               █
█     ║     /┬┴┬┴┤├┤├┼┤├┤├┴┬┴┬\     ║               ╔═╣~  ~ ║                               █
█     ║     ─┴─┴─┴╔═════╗┴─┴─┴─     ║             ╔═╝ ║  ~  ╠═╗                             █
█     ╚═══════════╝     ╚═══════════╝           ╔═╝   ║ ~  ~║ ╚═╗                           █
█                                             ╔═╝     ║~  ~ ║   ╚═╗                         █
█                                           ╔═╝       ║  ~  ║     ╚═════════════════════════█
█                                         ╔═╝         ║ ~  ~╚╗                              █
█                                       ╔═╝           ║~  ~  ╚╗                             █
█                                     ╔═╝             ╚╗ ~  ~ ╚╗                            █
█                                   ╔═╝                ╚╗  ~  ~╚════════════════════════════█
█                                 ╔═╝                   ╚╗~  ~  ~  ~  ~  ~  ~  ~  ~  ~  ~  ~█
█                               ╔═╝                      ╚╗ ~  ~  ~  ~  ~  ~  ~  ~  ~  ~  ~ █
█                        ╔══════╝                         ╚╗  ~  ~  ~  ~  ~  ~  ~  ~  ~  ~  █
█                      ╔═╝                                 ╚════════════════════════════════█
█                    ╔═╝                                                                    █
█                  ╔═╝                                                                      █
█                 ╔╩╗                               ╔═╗                                     █
█                 ║ ╚═╗                           ╔═╝ ║                                     █
█                 ║   ╚═══════════════════════════╝   ║                                     █
█                 ║                                   ║                                     █
█                 ╚═╗                               ╔═╝                                     █
█                   ╚═╗                           ╔═╝                                       █
█                     ╚═══════════════════════════╝                                         █
█                                                                                           █
█                                                                                           █
█                                                                                           █
█                                                                                           █
█                                                                                           █
█                           ╔═════════════════════╗                                         █
█                         ╔═╝                     ╚═╗                                       █
█                       ╔═╝                         ╚═╗                                     █
█                     ╔═╝                             ╚═╗                                   █
█                   ╔═╝                                 ╚═╗                                 █
█                 ╔═╝                                     ╚═╗                               █
█                 ║           ╔═════════════════╗           ║                               █
█                             ║                 ║           ║                               █
█                             ║  /¯¯¯¯¯¯¯¯¯¯¯\  ║           ║                               █
█                             ║ /¯¯¯¯¯¯¯¯¯¯¯¯¯\ ║           ║                               █
█                             ║ │¯¯¯¯¯¯¯¯¯¯¯¯¯│ ║           ║                               █
█                             ║ │┌┬┐┌─────┐┌┬┐│ ║           ║                               █
█                             ║ │└┴┘│┌┬┬┬┐│└┴┘│ ║           ║                               █
█                             ║ │   ││├┼┤││   │ ║           ║                               █
█                             ║ │  ┌┘├┤│├┤└┐  │ ║           ║                               █
█                             ║ └──┘╔═════╗└──┘ ║           ║                               █
█                             ╚═════╝     ╚═════╝           ║                               █
█                                                           ║                               █
█                                                           ║                               █
█                                                           ║                               █
█                                                           ║                               █
█                                                           ║                               █
█                                                           ║                               █
█                                                           ║                               █
█                                                           ║                               █
█                                                           ║                               █
█                                                           ║                               █
█                                                           ║                               █
█                                                           ║                               █
█████████████████████████████████████████████████████████████████████████████████████████████